111111111111111111111111111111111111111111111111111111111111111111
1110P000100001000010000C000010000100001000010000100001000010000101
111100000000010000100001000010000C000010000100001000010000C0000C01
111100000000000000C000010000C001010000C0000C0000C00C01000010000101
111000CE0000010000100001000010000100001000010000C00C01000010000101
111111111110010000C0000100001000010000100001000010000CC000C0000101
111111111111111111111111111111111111111111111111111111111111111111
